#######x#######
#............K#
#.D...........#
#.... ... ....#
#... ..... ...#
#.. ....... ..#
xL............x
#.............#
#...........A.#
#..   ...   ..#
#... ..... ...#
#.............#
#######x#######
