###############
#.#...KK#######
x..L### . ... #
#.......... . #
#####  #####. #
#.............#
#.#############
#............##
########### . #
#.............#
#.#####  ######
#.............x
###############
