#######x#######
#.....L.L.....#
#..S.LLLLL.S..#
#.....LLL.....#
#...       ...#
#.............#
x.............#
#.D...........x
#....     ....#
#.............#
#..W.     .W..#
#.............#
###############
