#######x#######
#....# . #....#
#.KK.# . #.KK.#
#....# . #....#
###### . ######
#      .      #
x.............x
#      .      #
###### . ######
#....# . #....#
#.KK.# . #.KK.#
#....# . #....#
#######x#######
