#######x#######
#.............#
#. ......... .#
#.. ....... ..#
#. ......... .#
#.. ....... ..#
x.............x
#.. ....... ..#
#. ......... .#
#.. ....... ..#
#. ......... .#
#.............#
#######x#######
