#######x#######
#.#.S.........#
#.........W.#.#
#..#..#.#.....#
#...S......#..#
#.D..D...AW.A.#
x.............x
#...S......#..#
#.D..D...AW.A.#
#.............#
#...S#........#
#..#......W#K.#
#######x#######
