###############
#....     ....#
#...       ...#
#....     ....#
###############
#..#..#..#..#.#
x.............x
#.#..#..#..#..#
###############
#....     ....#
#...       ...#
#....     ....#
###############
