###############
######...######
#####. . .#####
####. ... .####
###. .. .. .###
##. ... ... .##
x.... ... ...K#
##. ... ... .##
###. .. .. .###
####. ... .####
#####. . .#####
######...######
###############
