###############
##.....K.....##
#..D.......A..#
#...D.....A...#
#....D...A....#
#.....D.A.....#
#......D......#
#.....A.D.....#
#....A...D....#
#...A.....D...#
#..A.......D..#
####...@...####
#######x#######
