#######x#######
#...#.....#...#
#.S.#.....#...#
#...#.....#...#
#...#.....#...#
#...#.....#...#
#...#..@..#...#
#...#.....#...#
#...#.   .#...#
#...#     #...#
#...#     #.W.#
#...#.   .#...#
###############
