#######x#######
#.............#
#.LLLLLLLLLL..#
#.L........L..#
#.L..LLLLL.L..#
#.L..L...L.L..#
x.L..L.Q.L.L..x
#.L..L...L.L..#
#.L..LLLLL.L..#
#.L........L..#
#.LLLLLLLLLL..#
#.............#
#######x#######
