#######x#######
#.S.. ... ..S.#
#.... ... ....#
#.... ... ....#
#.... ... ....#
#.... ... ....#
#....  .  ....#
#.... ... ....#
#.... ... ....#
#.... ... ....#
#.... ... ....#
#..W. ... .W..#
#######x#######
