#######x#######
######...######
#####. . .#####
####. ... .####
###. .. .. .###
##. ... ... .##
x.... ... ....x
##. ... ... .##
###. .. .. .###
####. ... .####
#####. . .#####
######...######
#######x#######
